5 12
XXXXXXXXXXXX
X..........X
X.XXXXXXXXXX
X..........D
XXXXXXXXXXXX
